##########
#A...#...#
#.#.##.#.#
#.#.##.#.#
#.#....#B#
#.#.####.#
#....#...#
##########